68 57 57 56 57 56 57 57 57 57 55 57 55 57 57 72 
50 70 52 54 52 54 52 58 58 51 53 51 53 51 71 42 
48 44 1 0 0 0 0 0 0 0 0 0 0 33 35 39 
50 46 14 0 0 0 0 0 0 0 0 0 0 32 37 42 
48 44 13 0 0 0 0 0 0 0 0 0 0 31 35 39 
50 47 2 0 0 0 0 0 0 0 0 0 0 30 41 42 
50 47 3 0 0 0 0 0 0 0 0 0 0 29 41 42 
49 43 4 6 7 17 20 21 22 23 6 7 17 28 38 40 
50 45 5 8 9 16 19 74 74 24 8 9 16 27 36 42 
49 43 12 11 10 15 18 74 74 25 11 10 15 26 38 40 
50 69 60 62 60 75 76 74 74 75 76 59 61 59 67 42 
73 65 65 64 65 77 78 34 34 77 78 65 63 65 65 66 