45 35 35 34 35 34 53 35 35 52 33 35 33 35 35 43 
24 46 2 4 2 4 36 55 56 1 3 1 3 1 44 32
22 19 0 0 0 0 0 0 0 0 0 0 0 0 29 32
24 21 0 0 0 0 0 0 0 0 0 0 0 0 27 30
22 19 0 0 0 0 0 0 0 0 0 11 0 0 29 49
24 38 0 0 11 0 0 0 0 0 0 0 0 0 47 51
24 38 0 0 0 0 0 0 0 0 0 0 0 0 48 51
23 18 0 0 0 0 0 0 0 0 0 0 0 0 28 50
24 20 0 0 0 11 0 0 0 0 0 0 0 0 26 31
23 18 0 0 0 0 0 0 0 0 0 0 0 0 28 32
24 42 9 15 9 15 9 13 12 8 14 8 14 8 40 32
41 25 25 17 25 17 7 10 10 6 16 25 16 25 25 39